1111111111111
1C0100C0000C1
1000011111001
1P0C11E000001
1111111111111
