H111111111111111
11C000C000110001
111100WWWC110W11
11000000000000C1
1001100W1110G001
1PW000C1E0000001
1111111111111111
